EA ./textures/wall/M1.xpm
NO ./textures/wall/M3.xpm
SO ./textures/wall/M5.xpm
WE ./textures/wall/M2.xpm

F 220,100,0
C 225,30,0

11111111111111111111111111111111111111111
1b0000000S0111100000000000000000001111111
10000000000000000000000000000000000000001
100000000a0000000000000000000000000000001
10000000000000000000000000000000000000001
10000000000000000000000000000000000000001
10000000000000000000000000000000000000001
10000000000000000000000000000000000000001
11111111111111111111111111111111111111111

a h:50 p:./textures/barrel/frame_1.xpm  y:50 x:50
b p:./textures/barrel/frame_0.xpm h:50 x:50 y:50
