EA ./textures/wall/M1.xpm
NO ./textures/wall/M3.xpm
SO ./textures/wall/M5
WE ./textures/wall/M2.xpm

F 220,100,0
C 225,30,0

11111111111111111111111111111111111111111
10000000000111110000000000000000001111111
10000000000000010000000000000000000000001
100000000a0000010000000000000000000000001
100000000000000111111111111D1111111111111
100000000000000D0000000000000000000000001
100000000000000100000N0000000000000000001
10000000000000010000000000000000000000001
11111111111111111111111111111111111111111

c h:100 p:./textures/column.xpm  y:50 x:50
b p:./textures/barrel/frame_0 h:100 x:50 y:50
D ./textures/simonkraft/bookshelf.xpm
