EA ./textures/wall/M1.xpm
NO ./textures/wall/M3.xpm
SO ./textures/wall/M5
WE ./textures/wall/M2.xpm

F 220,100,0
C 225,30,0

11111111111111111111111111111111111111111
100000000001111000000b0000000000001111111
10000000000000000000c0c000000000000000001
100000000a0000000000c0c000000000000000001
10000000000000000000c0c000000000000000001
100000000000000D0000c0c000000000000000001
10000000000000010000cNc000000000000000001
10000000000000000000000000000000000000001
11111111111111111111111111111111111111111

c h:100 p:./textures/column.xpm  y:50 x:50
b p:./textures/barrel/frame_0 h:100 x:50 y:50
