C 17,17,17
F 43,52,62

EA ./assets/textures/wall/M1.xpm
NO ./assets/textures/wall/M3.xpm
SO ./assets/textures/wall/M5.xpm
WE ./assets/textures/wall/M2.xpm

11111111111111
100100100000001
10000011111111111111111111
10000010000000000000010001
10000010000000000000000001
10000010000000000000010001
11101111111011111111110001
111000110000001      100011
110100010000001      1000001
101000010000001      100011
10000000000000111111111011111111111
10000001000000100000000000000000001
100000010000001000000000000000000011111
110000110000001001110000000000110010001
111111111111111001000000000000010010001
              1000000000000000000010001
              1000000000000000000010001
              1000000000000000000000001
              1000000000000000000010001
              1000000000000000000010001
              1001000000000000010010001
              1001100000000000110010001
              1000000000000000000010001
              1000000000000000000010001
              1111111111111111111110001
                                  10001
                               11110001111
                               10000000001
   1111111111111               10000000001111
   1000000000001               10000000001
   1000000000001               10000000001
   1000000000001               10000000001
   1000000000001               10000000001
   1000000000001               10000000001
   10011111111111111111111     11111011111
   10000000000000000000001       100001
   11110000000000000000001       100001
      10000000000000000001       100001
  1111100000000000011101111111111100001
  1000000000000000010000000000000000001
  1000100000000000010000000000000000001
  1000100000000000010000000000000000001
  1000111111011111110000000000000000001
  1000000010001    11101111111111111111
  1000000010001    100000000001
  1000000010001    100000000001
  1111011110001    100000000001
    10001 10001    100000000001
    10001111111    100000000001
    10000000001    100000000001
    11111100001    111111011111
         110001        10N01
          10001        10001
           10001       10101
            10001      11111
             10001
              100011111111111111111111111111111111111111111
               10001100000000000000000000000000000000000001
                1000101111111111111111111111111111111111101
                1000001000100000100000001000000000101000101
                1110101010101110101110111011101110101110101
                1000100010101010100010000010101000000000101
                1010111011111010111111101010111011111111101
                1010101010000000001000001010001010001000101
                1011101111111111101011111010111111101010101
                1010101000100000101000001000001010000010101
                1010101010111011101110101111111011111110101
                1000001010100000100000101010001000100000101
                1010101011111110111011111010111110101110101
                1010100000001000001000000000001000000010101
                1110101011111011101010101110111011111111101
                1010101000000010000010100010000010000000101
                1010111011101011101010111111111010111110101
                1000100000101000101010100000001000001010101
                1011101110111010101111101110111011101010101
                1010001000101010100000100010001000101010101
                1011101010101110111110101110111110101010101
                1010001010100010100010000010001010101000101
                1011101010111010111010101111111011101110101
                1010101010000010100000100010001000101010101
                1010111010111111111010111110111010101010101
                1000100010001000000010001000001010101010101
                1010101110101010111111111011111011101011101
                1010101000101010000000000010000010001000101
                1010101111101111111111111010111111111110101
                1010100010100000100000100010100000100000101
                1110111010111111101011111010101011101111101
                1000100000001000001010001000001010000000101
                1011111111101110101010111111111011111110101
                1010000000100000101000001000001000101000101
                1110101011111011101111101011111110101010101
                1000101010000010000000101010000010001010101
                1010111010101110111110111010111011101011101
                1010100010101000001000001000100000001000101
                1010101110101011101111111111101011101010101
                1010100000101010100000000000101000100010101
                1010111111101010101110111110101110111110101111111
                1010000010001000101000000010101000000010000000001
                1111111111111111111111111111111111111111100000001
                                                        100000001
                                                        100000001
                                                         100000001     
                                                         100000001
                                                        111111111

