
   EA             ./textures/wall_1.xpm
NO          ./textures/wall_2.xpm
       SO             ./textures/wall_3.xpm
WE            ./textures/wall_4.xpm
F 120,000,0
C 100,30,0

1111111111111111111111111111111111111111111111111
1000000000000000000000001000000000000000000000001
1011111111111111111111101011111111111111111111101
1010000000000000000000001000000000000000000000101
1010111111111111111111111111111111111111111110101
1010100000000000000000000000000000000000000010101
1010101111111111111111111111111111111111111010101
1010101000000000000000001000000000000000001010101
1010101011111111111111101011111111111111101010101
1010101010000000000000001000000000000000101010101
1010101010111111111111111111111111111110101010101
1010101010100000000000000000000000000010101010101
1010101010101111111111111111111111111010101010101
1010101010101000000000001000000000001010101010101
1010101010101011111111101011111111101010101010101
1010101010101010000000001000000000101010101010101
1010101010101010111111111111111110101010101010101
1010101010101010100000000000000010101010101010101
1010101010101010101111111111111010101010101010101
1010101010101010101000001000001010101010101010101
1010101010101010101011101011101010101010101010101
1010101010101010101010001000101010101010101010101
1010101010101010101010111110101010101010101010101
101000101000101000101010S010100010100010100010101
1011111011111011111010100010111110111110111110101
1010001010001010001010100010100010100010100010101
1010101010101010101010110110101010101010101010101
1010101010101010101010010100101010101010101010101
1010101010101010101011010101101010101010101010101
1010101010101010101001010100001010101010101010101
1010101010101010101101010111111010101010101010101
1010101010101010100001010100000010101010101010101
1010101010101010111111010101111110101010101010101
1010101010101010000001010100000000101010101010101
1010101010101011111101010111111111101010101010101
1010101010101000000001010000000000001010101010101
1010101010101111111111011111111111111010101010101
1010101010100000000000010100000000000010101010101
1010101010111111111111111101111111111110101010101
1010101010000000000000000101000000000000101010101
1010101011111111111111110101011111111111101010101
1010101000000000000000010101000000000000001010101
1010101111111111111111010101111111111111111010101
1010100000000000000000010101000000000000000010101
1010111111111111111111110101011111111111111110101
1010000000000000000000010101000000000000000000101
1011111111111111111111010101111111111111111111101
1000000000000000000000010100000000000000000000001
1111111111111111111111111111111111111111111111111



